BBBBBBBBBBBBBBBBBBBBBBBBBBBBBBBBBBBBBBBBBBBBBBBBBBBBBBBBBBBBBBBBBBBBBBBBBBBBBBBBBBBBBBBBBBBBBBBB
B.........B..............D............B...............B...............B.................B....E.B
B.P.......B....E....D........D........B...............B.....B.........B.......E.........B...T..B
B.........B................B..........................B.....B.........B.................B.E....B
B..BBBBB..B......B..BBBBBBBB..........................BBBBBBB.........B.................B....E.B
B.....B...B......B.........BBBBBBBBBBBBBBB.......E...............B.........................BBBBB
B.....B...G..D...B.........B.............B.......................B..........B..................B
BBBBBBBB..G......B.......................B.......................B..........BBBBBBBBBBBBGGGGGGGB
B.........BBBBBBBBBBBBBBBBBBBBBBBBBBBBBBBBGGGGGBBBBBBBBBBBBBBBBBBBBB........B..................B
B.........B........B.....................B.....B...................B........B..................B
B.........B........B..............B......B.....B....BBBB...........BBBBBBBBBB..................B
B.........B.......................BBBBBBBB.....B.......B...........B........B..................B
B....BBBBBB..............B..................B..BBBBBBBBBBBBBBB.....B........B.......BBBB.....BBB
B.T..B....BBBBB....BBBBBBB..................B......................B................B..........B
BBBBBB....B...B....B.........BBBBBBBBBBBBBBBB......................B................B..........B
B.........B...B....B.........B..........B..........................B................B..........B
B......T..B........B....BBBBBB.......T..B..........................BBBBBBBBBBBBBBBBBB..........B
B.........B...BBBBBB....B...............BBBBBBBBBBBBBBBBBBBBBB.....B...........................B
B....BBBBBB........B....B.........BBBBBBBB.........................B...........................B
B.........B........B....B.........B................................B...........................B
B.........B........BBBBBB.........B................................B...........................B
B.........B........B..............B...........B.......BBBBBBB......B..........BBBBBBBBBBBBBBBBBB
B.........B........B.....BBBBBBBBBB...........B.......B............B..........B................B
B..............BBBBB.....B..............BBBBBBBBBBBBBBB............B..........B................B
BBBBB..........G.........B..............B..........................B..........B................B
B...B..........G.........B..............B..........................B..........B................B
B...B.....B....BBBBBBBBBBBBBBBBBBBBBBBBBB..........................B..........B................B
B...BBB...B........B.............G.................................B...........................B
B.........B........B.............G.................................B...........................B
BBBBBBB...B........B.............G...........BBBBBBBBBBBBBBB.......B...........................B
B.........B........B.............G...........B.....................BBBBBBBBBBBBBBBBBBB.........B
B.........B..............BBBBBBBBBBBBBBBBBBBBB.....................B.................B.........B
BBBB......B..............B............B...............B............B.................B.........B
B.........B..............B............B...............B............B.........B.......B.........B
B.........B..............B............................B............B.........B.......B.........B
B.........B..............BBBB.........................B............B.........B.......B.........B
B.........B..............B............................B............B.........B.................B
B.........B..............B.......................B....B............B.........B.................B
B...BBBBBBB..............B....BBBBBBBBBBBBBBBBBBBBBBBBBBBBBBB......B.........B.................B
B.........B....BBBBBBBBBBB....B..........................B.........B.........BBBBBBBBBBBBBBBBBBB
B.........B.....B........B....B..........................B.........B...........................B
B.........B.....B...T...............B............BBBBBBBBB.........B...........................B
B.........B.....B...................B............B.................BBBBBBBBBBBBBBBBB...........B
B.....BBBBBBBBBBBBBBBBBBBBBBBBBBBBBBB.......BBBBBBBBBBBBBBBBBBBBBBBB...............B.....T.....B
B........B...............B..........B.......B......................................B...........B
B........BBBBBB..........B.......T..B.......B.............B........................BBBBBBBBBBBBB
B........B...............B.....BBBBBB.......B.............BBBBBBBBBBBBBBBBBBB..................B
BBBBBBBBBB..........B....B..................BBBBBBBBBBBBBBB....................................B
B...............T...B....BBBBBB...........................B........................BBBBBBBB....B
B...................B.........G....................................................B...........B
BBBBBBBBBBBBBBBBBBBBBBBBBBBBBBBBBBBBBBBBBBBBBBBBBBBBBBBBBBBBBBBBBBBBBBBBBBBBBBBBBBBBBBBBBBBBBBBB
